Paradise
#############################################
#                                           #
#      ~~~~~~~       ~       ~~~~~~~~~      #
#      ~             ~           ~          #
#      ~             ~           ~          #
       ~~~~          ~           ~           
#      ~             ~           ~          #
#      ~             ~           ~          #
#      ~             ~           ~          #
#                                           #
#############################################