My map
#############################################    
#                                 ~~         #   
#    ~~~       ~~~       ~             ~~     #  
#      ~~       ~~~~           ~         ~     # 
#      ~~       ~~~~           ~~       ~~      #
                    ~~      ~~~~                 
#                            ~~                 #
#   ~                      ~~~~         ~      # 
#  ~~       ~~~      ~    ~~~~~      ~        #  
#        ~~~~~                      ~~       #   
#############################################    